,zipcode,tie,herb_wesson,holly_mitchell,total,winner_dist_two,winner_total
775,95814,0,18300,111150,129450,Holly Mitchell,111150
219,90010,0,81750,11550,93300,Herb Wesson,81750
258,90056,0,37160,36880,74040,Herb Wesson,37160
256,90049,0,41799,29350,71149,Herb Wesson,41799
218,90008,0,41818,28358,70176,Herb Wesson,41818
226,90017,0,46388,19915,66303,Herb Wesson,46388
228,90019,0,43265,21395,64660,Herb Wesson,43265
233,90024,0,31750,30850,62600,Herb Wesson,31750
229,90020,0,49350,7200,56550,Herb Wesson,49350
275,90210,0,42450,12550,55000,Herb Wesson,42450
264,90064,0,16950,33530,50480,Holly Mitchell,33530
252,90045,0,37350,10850,48200,Herb Wesson,37350
266,90066,0,19100,28544,47644,Holly Mitchell,28544
250,90043,0,15150,27702,42852,Holly Mitchell,27702
267,90067,0,29100,12900,42000,Herb Wesson,29100
432,91436,0,24600,17200,41800,Herb Wesson,24600
236,90027,0,29300,12250,41550,Herb Wesson,29300
282,90230,0,20700,20687,41387,Herb Wesson,20700
298,90272,0,25500,15705,41205,Herb Wesson,25500
296,90266,0,37950,1700,39650,Herb Wesson,37950
214,90004,0,24200,15300,39500,Herb Wesson,24200
243,90036,0,27400,11810,39210,Herb Wesson,27400
776,95815,0,5000,33900,38900,Holly Mitchell,33900
314,90402,0,12850,25200,38050,Holly Mitchell,25200
253,90046,0,20115,17700,37815,Herb Wesson,20115
234,90025,0,20625,15740,36365,Herb Wesson,20625
277,90212,0,29050,7150,36200,Herb Wesson,29050
224,90015,0,28615,6746,35361,Herb Wesson,28615
215,90005,0,34000,1350,35350,Herb Wesson,34000
276,90211,0,23350,8660,32010,Herb Wesson,23350
354,90802,0,19098,12150,31248,Herb Wesson,19098
269,90069,0,23250,7739,30989,Herb Wesson,23250
225,90016,0,24970,5495,30465,Herb Wesson,24970
270,90071,0,22300,6250,28550,Herb Wesson,22300
306,90292,0,20900,6650,27550,Herb Wesson,20900
221,90012,0,22850,3950,26800,Herb Wesson,22850
283,90232,0,7750,18460,26210,Holly Mitchell,18460
255,90048,0,21000,4700,25700,Herb Wesson,21000
216,90006,0,22962,100,23062,Herb Wesson,22962
295,90265,0,21000,1961,22961,Herb Wesson,21000
242,90035,0,12925,9885,22810,Herb Wesson,12925
369,91011,0,18745,3325,22070,Herb Wesson,18745
393,91302,0,15400,6400,21800,Herb Wesson,15400
305,90291,0,16000,5576,21576,Herb Wesson,16000
241,90034,0,13900,7345,21245,Herb Wesson,13900
227,90018,0,16625,4505,21130,Herb Wesson,16625
401,91326,0,20466,250,20716,Herb Wesson,20466
246,90039,0,8100,12200,20300,Holly Mitchell,12200
379,91105,0,10800,9275,20075,Herb Wesson,10800
317,90405,0,4450,15600,20050,Holly Mitchell,15600
427,91403,0,11200,8450,19650,Herb Wesson,11200
418,91367,0,15100,4350,19450,Herb Wesson,15100
268,90068,0,12000,6800,18800,Herb Wesson,12000
260,90058,0,17500,0,17500,Herb Wesson,17500
384,91202,0,5500,11950,17450,Holly Mitchell,11950
398,91316,0,16000,1250,17250,Herb Wesson,16000
307,90293,0,14100,2950,17050,Herb Wesson,14100
308,90301,0,9535,7500,17035,Herb Wesson,9535
300,90275,0,15500,1500,17000,Herb Wesson,15500
289,90250,0,10600,6350,16950,Herb Wesson,10600
301,90277,0,16850,100,16950,Herb Wesson,16850
438,91601,0,16500,250,16750,Herb Wesson,16500
376,91101,0,13500,2250,15750,Herb Wesson,13500
364,91001,0,10750,4950,15700,Herb Wesson,10750
568,92660,0,14015,1500,15515,Herb Wesson,14015
230,90021,0,14800,500,15300,Herb Wesson,14800
431,91423,0,7100,7597,14697,Holly Mitchell,7597
435,91505,0,7000,7600,14600,Holly Mitchell,7600
482,91801,0,6000,8450,14450,Holly Mitchell,8450
794,95841,0,3000,11392,14392,Holly Mitchell,11392
254,90047,0,9000,5330,14330,Herb Wesson,9000
235,90026,0,11365,2825,14190,Herb Wesson,11365
271,90077,0,8500,5450,13950,Herb Wesson,8500
795,95864,0,4500,9000,13500,Holly Mitchell,9000
237,90028,0,11500,1950,13450,Herb Wesson,11500
299,90274,0,9950,3450,13400,Herb Wesson,9950
651,94115,0,100,12950,13050,Holly Mitchell,12950
287,90248,0,9200,3500,12700,Herb Wesson,9200
312,90305,0,6700,5625,12325,Herb Wesson,6700
390,91208,0,12000,100,12100,Herb Wesson,12000
704,94612,0,0,12100,12100,Holly Mitchell,12100
359,90807,0,7600,4250,11850,Herb Wesson,7600
407,91344,0,11500,100,11600,Herb Wesson,11500
309,90302,0,7450,4100,11550,Herb Wesson,7450
251,90044,0,10500,950,11450,Herb Wesson,10500
670,94501,0,7500,3450,10950,Herb Wesson,7500
377,91103,0,4750,6050,10800,Holly Mitchell,6050
644,94107,0,4500,6172,10672,Holly Mitchell,6172
249,90042,0,7500,2812,10312,Herb Wesson,7500
440,91604,0,5550,4675,10225,Herb Wesson,5550
320,90503,0,8600,1550,10150,Herb Wesson,8600
380,91106,0,5000,5100,10100,Holly Mitchell,5100
232,90023,0,8500,1500,10000,Herb Wesson,8500
285,90245,0,7000,3000,10000,Herb Wesson,7000
326,90620,0,8500,1500,10000,Herb Wesson,8500
288,90249,0,9100,875,9975,Herb Wesson,9100
259,90057,0,6850,3000,9850,Herb Wesson,6850
381,91107,0,2700,7105,9805,Holly Mitchell,7105
265,90065,0,5250,4450,9700,Herb Wesson,5250
415,91361,0,8750,700,9450,Herb Wesson,8750
774,95811,0,3000,6450,9450,Holly Mitchell,6450
777,95816,0,2000,7300,9300,Holly Mitchell,7300
643,94105,0,250,9000,9250,Holly Mitchell,9000
358,90806,0,9000,0,9000,Herb Wesson,9000
367,91008,0,8800,0,8800,Herb Wesson,8800
316,90404,0,3500,5200,8700,Holly Mitchell,5200
313,90401,0,6000,2500,8500,Herb Wesson,6000
556,92618,0,6000,2500,8500,Herb Wesson,6000
315,90403,0,5500,2900,8400,Herb Wesson,5500
439,91602,0,6500,1850,8350,Herb Wesson,6500
392,91301,0,3500,4800,8300,Holly Mitchell,4800
321,90504,0,7500,800,8300,Herb Wesson,7500
417,91364,0,7750,500,8250,Herb Wesson,7750
355,90803,0,5000,3225,8225,Herb Wesson,5000
284,90241,0,7650,500,8150,Herb Wesson,7650
245,90038,0,2214,5900,8114,Holly Mitchell,5900
353,90755,0,8000,100,8100,Herb Wesson,8000
650,94114,0,0,8000,8000,Holly Mitchell,8000
559,92626,0,8000,0,8000,Herb Wesson,8000
632,94025,0,0,7850,7850,Holly Mitchell,7850
778,95818,0,500,7100,7600,Holly Mitchell,7100
697,94605,0,1500,6092,7592,Holly Mitchell,6092
630,94010,0,1500,6050,7550,Holly Mitchell,6050
382,91108,0,4550,3000,7550,Herb Wesson,4550
373,91030,0,4750,2750,7500,Herb Wesson,4750
409,91350,0,7500,0,7500,Herb Wesson,7500
222,90013,0,6000,1500,7500,Herb Wesson,6000
554,92614,0,5500,2000,7500,Herb Wesson,5500
220,90011,0,6250,1250,7500,Herb Wesson,6250
302,90278,0,5200,2200,7400,Herb Wesson,5200
347,90731,0,2750,4650,7400,Holly Mitchell,4650
330,90631,0,6750,500,7250,Herb Wesson,6750
416,91362,0,5750,1500,7250,Herb Wesson,5750
489,92024,0,1500,5750,7250,Holly Mitchell,5750
396,91307,0,6600,450,7050,Herb Wesson,6600
486,92011,0,6500,500,7000,Herb Wesson,6500
286,90247,0,6750,250,7000,Herb Wesson,6750
274,90201,0,7000,0,7000,Herb Wesson,7000
149,63105,0,1500,5500,7000,Holly Mitchell,5500
779,95819,0,1500,5400,6900,Holly Mitchell,5400
792,95835,0,0,6850,6850,Holly Mitchell,6850
757,95618,0,6000,800,6800,Herb Wesson,6000
48,20001,0,750,6000,6750,Holly Mitchell,6000
788,95831,0,1000,5650,6650,Holly Mitchell,5650
425,91401,0,4500,2150,6650,Herb Wesson,4500
352,90746,0,6100,500,6600,Herb Wesson,6100
278,90220,0,6600,0,6600,Herb Wesson,6600
711,94705,0,0,6561,6561,Holly Mitchell,6561
667,94402,0,0,6500,6500,Holly Mitchell,6500
722,94901,0,0,6500,6500,Holly Mitchell,6500
430,91411,0,6000,500,6500,Herb Wesson,6000
363,90815,0,5000,1500,6500,Herb Wesson,5000
735,95060,0,0,6500,6500,Holly Mitchell,6500
633,94027,0,1500,4722,6222,Holly Mitchell,4722
338,90703,0,4950,1100,6050,Herb Wesson,4950
142,60611,0,6000,0,6000,Herb Wesson,6000
470,91766,0,1500,4500,6000,Holly Mitchell,4500
590,92868,0,3000,3000,6000,Herb Wesson,3000
584,92833,0,4500,1500,6000,Herb Wesson,4500
441,91605,0,6000,0,6000,Herb Wesson,6000
434,91504,0,6000,0,6000,Herb Wesson,6000
509,92120,0,0,6000,6000,Holly Mitchell,6000
414,91356,0,5050,900,5950,Herb Wesson,5050
322,90505,0,5500,200,5700,Herb Wesson,5500
223,90014,0,4250,1275,5525,Herb Wesson,4250
602,93065,0,4000,1500,5500,Herb Wesson,4000
771,95757,0,250,5213,5463,Holly Mitchell,5213
791,95834,0,0,5450,5450,Holly Mitchell,5450
446,91702,0,4900,500,5400,Herb Wesson,4900
490,92037,0,3500,1800,5300,Herb Wesson,3500
261,90059,0,2300,3000,5300,Holly Mitchell,3000
332,90640,0,4500,600,5100,Herb Wesson,4500
279,90221,0,5100,0,5100,Herb Wesson,5100
303,90280,0,4800,300,5100,Herb Wesson,4800
683,94563,0,0,5000,5000,Holly Mitchell,5000
646,94109,0,0,5000,5000,Holly Mitchell,5000
247,90040,0,5000,0,5000,Herb Wesson,5000
248,90041,0,2550,2400,4950,Herb Wesson,2550
318,90501,0,3500,1450,4950,Herb Wesson,3500
240,90033,0,3700,1250,4950,Herb Wesson,3700
469,91765,0,4900,0,4900,Herb Wesson,4900
391,91214,0,4250,600,4850,Herb Wesson,4250
699,94607,0,1500,3300,4800,Holly Mitchell,3300
472,91770,0,4500,250,4750,Herb Wesson,4500
436,91506,0,4000,750,4750,Herb Wesson,4000
57,20036,0,1750,3000,4750,Holly Mitchell,3000
575,92780,0,3250,1500,4750,Herb Wesson,3250
641,94103,0,3000,1750,4750,Herb Wesson,3000
294,90262,0,4750,0,4750,Herb Wesson,4750
366,91007,0,3400,1300,4700,Herb Wesson,3400
272,90094,0,3250,1450,4700,Herb Wesson,3250
714,94708,0,250,4400,4650,Holly Mitchell,4400
375,91042,0,4600,0,4600,Herb Wesson,4600
211,90001,0,4500,100,4600,Herb Wesson,4500
244,90037,0,3500,1100,4600,Herb Wesson,3500
478,91789,0,4500,0,4500,Herb Wesson,4500
153,63146,0,4500,0,4500,Herb Wesson,4500
411,91352,0,4500,0,4500,Herb Wesson,4500
351,90745,0,4500,0,4500,Herb Wesson,4500
763,95661,0,3000,1500,4500,Herb Wesson,3000
346,90723,0,4500,0,4500,Herb Wesson,4500
588,92861,0,3000,1500,4500,Herb Wesson,3000
549,92592,0,3000,1500,4500,Herb Wesson,3000
466,91754,0,1850,2460,4310,Holly Mitchell,2460
706,94618,0,0,4300,4300,Holly Mitchell,4300
648,94111,0,1000,3266,4266,Holly Mitchell,3266
231,90022,0,2500,1750,4250,Herb Wesson,2500
462,91746,0,4150,0,4150,Herb Wesson,4150
456,91732,0,4100,0,4100,Herb Wesson,4100
413,91355,0,4100,0,4100,Herb Wesson,4100
578,92807,0,3000,1000,4000,Herb Wesson,3000
71,2116,0,0,4000,4000,Holly Mitchell,4000
770,95746,0,0,4000,4000,Holly Mitchell,4000
428,91405,0,3600,275,3875,Herb Wesson,3600
291,90254,0,3000,850,3850,Herb Wesson,3000
348,90732,0,1600,2250,3850,Holly Mitchell,2250
394,91303,0,2000,1750,3750,Herb Wesson,2000
429,91406,0,3500,250,3750,Herb Wesson,3500
516,92203,0,3749,0,3749,Herb Wesson,3749
329,90630,0,3700,0,3700,Herb Wesson,3700
365,91006,0,3600,100,3700,Herb Wesson,3600
454,91730,0,3400,200,3600,Herb Wesson,3400
405,91342,0,2500,1050,3550,Herb Wesson,2500
652,94117,0,0,3545,3545,Holly Mitchell,3545
564,92649,0,3500,0,3500,Herb Wesson,3500
402,91331,0,2000,1500,3500,Herb Wesson,2000
331,90638,0,2500,1000,3500,Herb Wesson,2500
9,10014,0,1500,2000,3500,Holly Mitchell,2000
397,91311,0,3000,500,3500,Herb Wesson,3000
51,20004,0,0,3500,3500,Holly Mitchell,3500
537,92503,0,3000,500,3500,Herb Wesson,3000
238,90031,0,3000,450,3450,Herb Wesson,3000
532,92405,0,3400,0,3400,Herb Wesson,3400
406,91343,0,3250,100,3350,Herb Wesson,3250
443,91607,0,2250,1100,3350,Herb Wesson,2250
304,90290,0,0,3300,3300,Holly Mitchell,3300
663,94303,0,0,3250,3250,Holly Mitchell,3250
723,94904,0,0,3250,3250,Holly Mitchell,3250
733,95032,0,0,3250,3250,Holly Mitchell,3250
700,94608,0,0,3250,3250,Holly Mitchell,3250
718,94804,0,0,3200,3200,Holly Mitchell,3200
727,94949,0,0,3200,3200,Holly Mitchell,3200
311,90304,0,3100,0,3100,Herb Wesson,3100
340,90710,0,3100,0,3100,Herb Wesson,3100
637,94065,0,0,3000,3000,Holly Mitchell,3000
591,92870,0,3000,0,3000,Herb Wesson,3000
371,91020,0,3000,0,3000,Herb Wesson,3000
395,91304,0,2300,700,3000,Herb Wesson,2300
749,95404,0,0,3000,3000,Holly Mitchell,3000
740,95122,0,3000,0,3000,Herb Wesson,3000
734,95037,0,0,3000,3000,Holly Mitchell,3000
400,91325,0,3000,0,3000,Herb Wesson,3000
408,91345,0,3000,0,3000,Herb Wesson,3000
724,94920,0,0,3000,3000,Holly Mitchell,3000
437,91522,0,1500,1500,3000,Herb Wesson,1500
444,91608,0,3000,0,3000,Herb Wesson,3000
484,91902,0,3000,0,3000,Herb Wesson,3000
485,92008,0,3000,0,3000,Herb Wesson,3000
491,92040,0,0,3000,3000,Holly Mitchell,3000
522,92316,0,3000,0,3000,Herb Wesson,3000
682,94558,0,0,3000,3000,Holly Mitchell,3000
550,92602,0,0,3000,3000,Holly Mitchell,3000
576,92804,0,3000,0,3000,Herb Wesson,3000
586,92844,0,3000,0,3000,Herb Wesson,3000
493,92075,0,3000,0,3000,Herb Wesson,3000
0,00nan,0,3000,0,3000,Herb Wesson,3000
194,85033,0,3000,0,3000,Herb Wesson,3000
69,21076,0,0,3000,3000,Holly Mitchell,3000
13,10022,0,3000,0,3000,Herb Wesson,3000
173,78249,0,3000,0,3000,Herb Wesson,3000
151,63131,0,1500,1500,3000,Herb Wesson,1500
143,60614,0,3000,0,3000,Herb Wesson,3000
179,78732,0,3000,0,3000,Herb Wesson,3000
137,60035,0,3000,0,3000,Herb Wesson,3000
136,60015,0,0,3000,3000,Holly Mitchell,3000
133,54481,0,0,3000,3000,Holly Mitchell,3000
53,20006,0,3000,0,3000,Herb Wesson,3000
169,77002,0,0,3000,3000,Holly Mitchell,3000
85,27514,0,3000,0,3000,Herb Wesson,3000
30,11238,0,0,3000,3000,Holly Mitchell,3000
33,11542,0,3000,0,3000,Herb Wesson,3000
167,76131,0,1500,1500,3000,Herb Wesson,1500
49,20002,0,3000,0,3000,Herb Wesson,3000
45,19192,0,0,3000,3000,Holly Mitchell,3000
205,89102,0,1500,1500,3000,Herb Wesson,1500
362,90814,0,0,2960,2960,Holly Mitchell,2960
378,91104,0,1650,1300,2950,Herb Wesson,1650
782,95822,0,0,2950,2950,Holly Mitchell,2950
217,90007,0,2500,350,2850,Herb Wesson,2500
212,90002,0,700,2150,2850,Holly Mitchell,2150
127,48070,0,2840,0,2840,Herb Wesson,2840
805,98103,0,2840,0,2840,Herb Wesson,2840
571,92679,0,2800,0,2800,Herb Wesson,2800
448,91709,0,1000,1750,2750,Holly Mitchell,1750
426,91402,0,2600,150,2750,Herb Wesson,2600
694,94602,0,1500,1200,2700,Herb Wesson,1500
372,91024,0,500,2000,2500,Holly Mitchell,2000
350,90744,0,2500,0,2500,Herb Wesson,2500
642,94104,0,0,2500,2500,Holly Mitchell,2500
769,95722,0,0,2500,2500,Holly Mitchell,2500
625,93901,0,0,2500,2500,Holly Mitchell,2500
558,92625,0,1500,1000,2500,Herb Wesson,1500
565,92651,0,2500,0,2500,Herb Wesson,2500
103,32830,0,0,2500,2500,Holly Mitchell,2500
207,89117,0,2500,0,2500,Herb Wesson,2500
687,94577,0,1000,1500,2500,Holly Mitchell,1500
496,92101,0,0,2500,2500,Holly Mitchell,2500
703,94611,0,0,2500,2500,Holly Mitchell,2500
572,92701,0,2500,0,2500,Herb Wesson,2500
467,91761,0,2500,0,2500,Herb Wesson,2500
468,91764,0,1000,1500,2500,Holly Mitchell,1500
458,91740,0,2500,0,2500,Herb Wesson,2500
191,84020,0,0,2500,2500,Holly Mitchell,2500
424,91390,0,2500,0,2500,Herb Wesson,2500
666,94306,0,0,2425,2425,Holly Mitchell,2425
319,90502,0,1850,550,2400,Herb Wesson,1850
403,91335,0,2000,398,2398,Herb Wesson,2000
732,95030,0,0,2261,2261,Holly Mitchell,2261
553,92612,0,2000,250,2250,Herb Wesson,2000
239,90032,0,600,1600,2200,Holly Mitchell,1600
323,90602,0,2000,200,2200,Herb Wesson,2000
465,91752,0,2185,0,2185,Herb Wesson,2185
310,90303,0,1700,450,2150,Herb Wesson,1700
600,93035,0,2000,100,2100,Herb Wesson,2000
389,91207,0,2000,100,2100,Herb Wesson,2000
631,94022,0,0,2100,2100,Holly Mitchell,2100
370,91016,0,1500,598,2098,Herb Wesson,1500
772,95758,0,0,2025,2025,Holly Mitchell,2025
7,10011,0,500,1500,2000,Holly Mitchell,1500
664,94304,0,0,2000,2000,Holly Mitchell,2000
573,92705,0,1500,500,2000,Herb Wesson,1500
87,27610,0,2000,0,2000,Herb Wesson,2000
12,10019,0,1500,500,2000,Herb Wesson,1500
570,92677,0,2000,0,2000,Herb Wesson,2000
562,92647,0,1500,500,2000,Herb Wesson,1500
764,95667,0,0,2000,2000,Holly Mitchell,2000
186,80466,0,0,2000,2000,Holly Mitchell,2000
196,85255,0,2000,0,2000,Herb Wesson,2000
488,92019,0,0,2000,2000,Holly Mitchell,2000
78,22204,0,2000,0,2000,Herb Wesson,2000
616,93536,0,2000,0,2000,Herb Wesson,2000
713,94707,0,0,1950,1950,Holly Mitchell,1950
525,92336,0,400,1500,1900,Holly Mitchell,1500
502,92108,0,1500,350,1850,Herb Wesson,1500
464,91750,0,1850,0,1850,Herb Wesson,1850
709,94702,0,0,1850,1850,Holly Mitchell,1850
790,95833,0,0,1850,1850,Holly Mitchell,1850
107,33160,0,1800,0,1800,Herb Wesson,1800
130,48855,0,1800,0,1800,Herb Wesson,1800
563,92648,0,800,1000,1800,Holly Mitchell,1000
360,90808,0,1450,350,1800,Herb Wesson,1450
334,90660,0,800,1000,1800,Holly Mitchell,1000
526,92337,0,1800,0,1800,Herb Wesson,1800
693,94601,0,0,1800,1800,Holly Mitchell,1800
388,91206,0,1500,250,1750,Herb Wesson,1500
477,91786,0,1750,0,1750,Herb Wesson,1750
361,90810,0,1500,250,1750,Herb Wesson,1500
789,95832,0,0,1750,1750,Holly Mitchell,1750
585,92835,0,1500,225,1725,Herb Wesson,1500
335,90670,0,1700,0,1700,Herb Wesson,1700
399,91324,0,1700,0,1700,Herb Wesson,1700
688,94578,0,1500,100,1600,Herb Wesson,1500
786,95828,0,0,1600,1600,Holly Mitchell,1600
387,91205,0,1600,0,1600,Herb Wesson,1600
517,92220,0,0,1600,1600,Holly Mitchell,1600
280,90222,0,1100,500,1600,Herb Wesson,1100
293,90260,0,1100,500,1600,Herb Wesson,1100
423,91387,0,1600,0,1600,Herb Wesson,1600
325,90606,0,1500,100,1600,Herb Wesson,1500
611,93460,0,100,1500,1600,Holly Mitchell,1500
781,95821,0,0,1600,1600,Holly Mitchell,1600
461,91745,0,550,1000,1550,Holly Mitchell,1000
758,95624,0,0,1550,1550,Holly Mitchell,1550
614,93534,0,1500,0,1500,Herb Wesson,1500
494,92082,0,0,1500,1500,Holly Mitchell,1500
197,85258,0,0,1500,1500,Holly Mitchell,1500
498,92104,0,1500,0,1500,Herb Wesson,1500
499,92105,0,0,1500,1500,Holly Mitchell,1500
617,93550,0,1500,0,1500,Herb Wesson,1500
199,8807,0,0,1500,1500,Holly Mitchell,1500
46,19850,0,0,1500,1500,Holly Mitchell,1500
504,92111,0,0,1500,1500,Holly Mitchell,1500
59,20148,0,1500,0,1500,Herb Wesson,1500
612,93463,0,1500,0,1500,Herb Wesson,1500
77,22202,0,0,1500,1500,Holly Mitchell,1500
508,92119,0,0,1500,1500,Holly Mitchell,1500
76,22079,0,1500,0,1500,Herb Wesson,1500
510,92121,0,1500,0,1500,Herb Wesson,1500
511,92124,0,0,1500,1500,Holly Mitchell,1500
512,92127,0,1500,0,1500,Herb Wesson,1500
513,92128,0,1500,0,1500,Herb Wesson,1500
210,89411,0,1500,0,1500,Herb Wesson,1500
80,22303,0,0,1500,1500,Holly Mitchell,1500
47,19884,0,0,1500,1500,Holly Mitchell,1500
471,91767,0,1500,0,1500,Herb Wesson,1500
459,91741,0,1500,0,1500,Herb Wesson,1500
712,94706,0,0,1500,1500,Holly Mitchell,1500
90,2895,0,0,1500,1500,Holly Mitchell,1500
52,20005,0,0,1500,1500,Holly Mitchell,1500
193,85012,0,1500,0,1500,Herb Wesson,1500
626,93906,0,0,1500,1500,Holly Mitchell,1500
88,28217,0,0,1500,1500,Holly Mitchell,1500
807,98109,0,1500,0,1500,Herb Wesson,1500
86,27605,0,0,1500,1500,Holly Mitchell,1500
75,22066,0,1500,0,1500,Herb Wesson,1500
624,93727,0,1500,0,1500,Herb Wesson,1500
708,94621,0,1500,0,1500,Herb Wesson,1500
634,94044,0,1500,0,1500,Herb Wesson,1500
479,91790,0,1500,0,1500,Herb Wesson,1500
806,98104,0,0,1500,1500,Holly Mitchell,1500
83,27101,0,1500,0,1500,Herb Wesson,1500
796,96002,0,1500,0,1500,Herb Wesson,1500
640,94080,0,0,1500,1500,Holly Mitchell,1500
514,92129,0,0,1500,1500,Holly Mitchell,1500
690,94583,0,1500,0,1500,Herb Wesson,1500
610,93455,0,1500,0,1500,Herb Wesson,1500
38,17011,0,0,1500,1500,Holly Mitchell,1500
603,93101,0,1500,0,1500,Herb Wesson,1500
42,19002,0,1500,0,1500,Herb Wesson,1500
803,98006,0,0,1500,1500,Holly Mitchell,1500
560,92629,0,1500,0,1500,Herb Wesson,1500
599,93021,0,1500,0,1500,Herb Wesson,1500
653,94118,0,500,1000,1500,Holly Mitchell,1000
65,20817,0,0,1500,1500,Holly Mitchell,1500
567,92656,0,1500,0,1500,Herb Wesson,1500
800,96813,0,1500,0,1500,Herb Wesson,1500
672,94513,0,0,1500,1500,Holly Mitchell,1500
594,92886,0,1500,0,1500,Herb Wesson,1500
656,94123,0,0,1500,1500,Holly Mitchell,1500
802,98004,0,0,1500,1500,Holly Mitchell,1500
589,92865,0,1500,0,1500,Herb Wesson,1500
62,20601,0,1500,0,1500,Herb Wesson,1500
61,20191,0,0,1500,1500,Holly Mitchell,1500
580,92821,0,1500,0,1500,Herb Wesson,1500
581,92823,0,1500,0,1500,Herb Wesson,1500
669,94404,0,0,1500,1500,Holly Mitchell,1500
297,90270,0,1500,0,1500,Herb Wesson,1500
58,20076,0,0,1500,1500,Holly Mitchell,1500
607,93308,0,1500,0,1500,Herb Wesson,1500
519,92260,0,1500,0,1500,Herb Wesson,1500
689,94579,0,0,1500,1500,Holly Mitchell,1500
74,22046,0,1500,0,1500,Herb Wesson,1500
524,92335,0,1500,0,1500,Herb Wesson,1500
609,93314,0,1500,0,1500,Herb Wesson,1500
608,93309,0,1500,0,1500,Herb Wesson,1500
200,8889,0,0,1500,1500,Holly Mitchell,1500
686,94574,0,1500,0,1500,Herb Wesson,1500
685,94566,0,0,1500,1500,Holly Mitchell,1500
43,19103,0,0,1500,1500,Holly Mitchell,1500
678,94541,0,1500,0,1500,Herb Wesson,1500
677,94536,0,0,1500,1500,Holly Mitchell,1500
645,94108,0,0,1500,1500,Holly Mitchell,1500
547,92563,0,1500,0,1500,Herb Wesson,1500
548,92585,0,1500,0,1500,Herb Wesson,1500
70,2110,0,1500,0,1500,Herb Wesson,1500
201,89011,0,1500,0,1500,Herb Wesson,1500
552,92610,0,1500,0,1500,Herb Wesson,1500
68,21046,0,0,1500,1500,Holly Mitchell,1500
2,10003,0,0,1500,1500,Holly Mitchell,1500
124,45209,0,0,1500,1500,Holly Mitchell,1500
120,38115,0,0,1500,1500,Holly Mitchell,1500
129,48854,0,0,1500,1500,Holly Mitchell,1500
18,10038,0,1500,0,1500,Herb Wesson,1500
455,91731,0,1500,0,1500,Herb Wesson,1500
123,43222,0,1500,0,1500,Herb Wesson,1500
10,10017,0,1500,0,1500,Herb Wesson,1500
746,95353,0,0,1500,1500,Holly Mitchell,1500
1,10001,0,0,1500,1500,Holly Mitchell,1500
165,75248,0,1500,0,1500,Herb Wesson,1500
745,95252,0,0,1500,1500,Holly Mitchell,1500
324,90603,0,1500,0,1500,Herb Wesson,1500
164,75202,0,0,1500,1500,Holly Mitchell,1500
410,91351,0,1500,0,1500,Herb Wesson,1500
741,95124,0,0,1500,1500,Holly Mitchell,1500
19,10153,0,0,1500,1500,Holly Mitchell,1500
168,76134,0,0,1500,1500,Holly Mitchell,1500
736,95112,0,0,1500,1500,Holly Mitchell,1500
113,37160,0,0,1500,1500,Holly Mitchell,1500
112,33634,0,0,1500,1500,Holly Mitchell,1500
111,33558,0,1500,0,1500,Herb Wesson,1500
419,91372,0,1500,0,1500,Herb Wesson,1500
131,53589,0,0,1500,1500,Holly Mitchell,1500
341,90712,0,1500,0,1500,Herb Wesson,1500
22,10577,0,0,1500,1500,Holly Mitchell,1500
368,91010,0,1500,0,1500,Herb Wesson,1500
156,65101,0,1500,0,1500,Herb Wesson,1500
160,6880,0,1500,0,1500,Herb Wesson,1500
154,63301,0,1500,0,1500,Herb Wesson,1500
152,63132,0,1500,0,1500,Herb Wesson,1500
174,78288,0,0,1500,1500,Holly Mitchell,1500
150,63127,0,1500,0,1500,Herb Wesson,1500
161,75063,0,1500,0,1500,Herb Wesson,1500
17,10036,0,0,1500,1500,Holly Mitchell,1500
146,6156,0,0,1500,1500,Holly Mitchell,1500
344,90717,0,1500,0,1500,Herb Wesson,1500
134,55343,0,0,1500,1500,Holly Mitchell,1500
177,78730,0,0,1500,1500,Holly Mitchell,1500
178,78731,0,1500,0,1500,Herb Wesson,1500
374,91040,0,1500,0,1500,Herb Wesson,1500
343,90716,0,1500,0,1500,Herb Wesson,1500
141,60610,0,1500,0,1500,Herb Wesson,1500
139,60062,0,0,1500,1500,Holly Mitchell,1500
180,7901,0,0,1500,1500,Holly Mitchell,1500
138,60045,0,1500,0,1500,Herb Wesson,1500
383,91201,0,1500,0,1500,Herb Wesson,1500
20,10154,0,0,1500,1500,Holly Mitchell,1500
158,67205,0,1500,0,1500,Herb Wesson,1500
728,94954,0,1500,0,1500,Herb Wesson,1500
98,30349,0,1500,0,1500,Herb Wesson,1500
450,91711,0,0,1500,1500,Holly Mitchell,1500
5,1001,0,0,1500,1500,Holly Mitchell,1500
24,11001,0,1500,0,1500,Herb Wesson,1500
433,91501,0,1500,0,1500,Herb Wesson,1500
104,33024,0,1500,0,1500,Herb Wesson,1500
192,85004,0,1500,0,1500,Herb Wesson,1500
25,11201,0,1500,0,1500,Herb Wesson,1500
99,30350,0,0,1500,1500,Holly Mitchell,1500
93,30134,0,1500,0,1500,Herb Wesson,1500
106,33139,0,1500,0,1500,Herb Wesson,1500
26,11206,0,1500,0,1500,Herb Wesson,1500
109,33408,0,0,1500,1500,Holly Mitchell,1500
23,1060,0,0,1500,1500,Holly Mitchell,1500
11,10018,0,0,1500,1500,Holly Mitchell,1500
730,95008,0,0,1500,1500,Holly Mitchell,1500
719,94805,0,0,1450,1450,Holly Mitchell,1450
473,91773,0,1250,100,1350,Herb Wesson,1250
710,94703,0,0,1300,1300,Holly Mitchell,1300
726,94941,0,0,1300,1300,Holly Mitchell,1300
442,91606,0,1100,200,1300,Herb Wesson,1100
15,10024,0,1250,0,1250,Herb Wesson,1250
587,92860,0,1250,0,1250,Herb Wesson,1250
339,90706,0,750,500,1250,Herb Wesson,750
520,92264,0,0,1250,1250,Holly Mitchell,1250
695,94603,0,0,1250,1250,Holly Mitchell,1250
647,94110,0,0,1200,1200,Holly Mitchell,1200
188,80919,0,0,1200,1200,Holly Mitchell,1200
539,92505,0,1000,200,1200,Herb Wesson,1000
357,90805,0,850,250,1100,Herb Wesson,850
184,80238,0,1000,100,1100,Herb Wesson,1000
356,90804,0,500,600,1100,Holly Mitchell,600
445,91701,0,0,1100,1100,Holly Mitchell,1100
684,94564,0,0,1100,1100,Holly Mitchell,1100
596,93001,0,1000,100,1100,Herb Wesson,1000
593,92881,0,1000,100,1100,Herb Wesson,1000
41,1864,0,1000,0,1000,Herb Wesson,1000
204,89052,0,1000,0,1000,Herb Wesson,1000
566,92653,0,1000,0,1000,Herb Wesson,1000
135,55402,0,0,1000,1000,Holly Mitchell,1000
785,95827,0,1000,0,1000,Herb Wesson,1000
784,95826,0,0,1000,1000,Holly Mitchell,1000
349,90740,0,1000,0,1000,Herb Wesson,1000
480,91791,0,1000,0,1000,Herb Wesson,1000
449,91710,0,1000,0,1000,Herb Wesson,1000
60,20190,0,1000,0,1000,Herb Wesson,1000
40,1742,0,1000,0,1000,Herb Wesson,1000
577,92806,0,0,1000,1000,Holly Mitchell,1000
804,98101,0,0,1000,1000,Holly Mitchell,1000
579,92808,0,1000,0,1000,Herb Wesson,1000
162,75067,0,0,1000,1000,Holly Mitchell,1000
463,91748,0,1000,0,1000,Herb Wesson,1000
753,95465,0,0,1000,1000,Holly Mitchell,1000
725,94939,0,1000,0,1000,Herb Wesson,1000
345,90720,0,1000,0,1000,Herb Wesson,1000
195,85213,0,0,1000,1000,Holly Mitchell,1000
507,92118,0,1000,0,1000,Herb Wesson,1000
125,46285,0,0,1000,1000,Holly Mitchell,1000
128,48275,0,0,1000,1000,Holly Mitchell,1000
797,96005,0,0,1000,1000,Holly Mitchell,1000
79,22209,0,0,1000,1000,Holly Mitchell,1000
747,95356,0,1000,0,1000,Herb Wesson,1000
35,12833,0,1000,0,1000,Herb Wesson,1000
680,94549,0,0,1000,1000,Holly Mitchell,1000
84,27215,0,1000,0,1000,Herb Wesson,1000
100,31906,0,0,1000,1000,Holly Mitchell,1000
743,95128,0,1000,0,1000,Herb Wesson,1000
673,94518,0,1000,0,1000,Herb Wesson,1000
119,38103,0,0,1000,1000,Holly Mitchell,1000
6,10010,0,0,1000,1000,Holly Mitchell,1000
523,92324,0,1000,0,1000,Herb Wesson,1000
551,92606,0,0,1000,1000,Holly Mitchell,1000
31,11413,0,0,1000,1000,Holly Mitchell,1000
798,96007,0,0,1000,1000,Holly Mitchell,1000
105,33126,0,1000,0,1000,Herb Wesson,1000
627,93921,0,1000,0,1000,Herb Wesson,1000
751,95418,0,0,1000,1000,Holly Mitchell,1000
108,33322,0,1000,0,1000,Herb Wesson,1000
503,92109,0,0,1000,1000,Holly Mitchell,1000
163,75201,0,0,1000,1000,Holly Mitchell,1000
768,95695,0,0,950,950,Holly Mitchell,950
531,92404,0,800,150,950,Herb Wesson,800
420,91377,0,500,450,950,Herb Wesson,500
702,94610,0,0,900,900,Holly Mitchell,900
692,94590,0,0,900,900,Holly Mitchell,900
533,92407,0,800,100,900,Herb Wesson,800
675,94530,0,0,875,875,Holly Mitchell,875
262,90062,0,500,350,850,Herb Wesson,500
707,94619,0,0,850,850,Holly Mitchell,850
701,94609,0,0,817,817,Holly Mitchell,817
527,92374,0,800,0,800,Herb Wesson,800
783,95825,0,0,800,800,Holly Mitchell,800
542,92508,0,800,0,800,Herb Wesson,800
386,91204,0,0,800,800,Holly Mitchell,800
696,94604,0,0,750,750,Holly Mitchell,750
752,95448,0,0,750,750,Holly Mitchell,750
483,91803,0,750,0,750,Herb Wesson,750
506,92116,0,0,750,750,Holly Mitchell,750
110,33455,0,0,750,750,Holly Mitchell,750
385,91203,0,250,500,750,Holly Mitchell,500
263,90063,0,500,200,700,Herb Wesson,500
767,95691,0,0,700,700,Holly Mitchell,700
327,90621,0,700,0,700,Herb Wesson,700
660,94131,0,0,700,700,Holly Mitchell,700
529,92377,0,0,700,700,Holly Mitchell,700
649,94112,0,0,700,700,Holly Mitchell,700
582,92831,0,0,650,650,Holly Mitchell,650
541,92507,0,0,650,650,Holly Mitchell,650
540,92506,0,0,600,600,Holly Mitchell,600
50,20003,0,500,100,600,Herb Wesson,500
662,94301,0,0,550,550,Holly Mitchell,550
729,94970,0,0,500,500,Holly Mitchell,500
737,95113,0,0,500,500,Holly Mitchell,500
744,95203,0,0,500,500,Holly Mitchell,500
37,15208,0,0,500,500,Holly Mitchell,500
671,94507,0,0,500,500,Holly Mitchell,500
799,96065,0,0,500,500,Holly Mitchell,500
668,94403,0,0,500,500,Holly Mitchell,500
39,17268,0,500,0,500,Herb Wesson,500
754,95570,0,0,500,500,Holly Mitchell,500
658,94127,0,0,500,500,Holly Mitchell,500
717,94803,0,0,500,500,Holly Mitchell,500
809,98204,0,500,0,500,Herb Wesson,500
534,92408,0,0,500,500,Holly Mitchell,500
457,91739,0,400,100,500,Herb Wesson,400
140,60606,0,500,0,500,Herb Wesson,500
81,22314,0,500,0,500,Herb Wesson,500
404,91340,0,0,500,500,Holly Mitchell,500
121,38116,0,0,500,500,Holly Mitchell,500
481,91792,0,0,500,500,Holly Mitchell,500
474,91776,0,0,500,500,Holly Mitchell,500
101,32082,0,500,0,500,Herb Wesson,500
97,30345,0,0,500,500,Holly Mitchell,500
546,92557,0,0,500,500,Holly Mitchell,500
94,30317,0,0,500,500,Holly Mitchell,500
574,92706,0,0,500,500,Holly Mitchell,500
628,93923,0,0,500,500,Holly Mitchell,500
92,29485,0,500,0,500,Herb Wesson,500
91,29448,0,500,0,500,Herb Wesson,500
561,92646,0,500,0,500,Herb Wesson,500
147,63011,0,500,0,500,Herb Wesson,500
555,92617,0,500,0,500,Herb Wesson,500
54,20010,0,0,500,500,Holly Mitchell,500
543,92509,0,500,0,500,Herb Wesson,500
209,89135,0,500,0,500,Herb Wesson,500
208,89121,0,500,0,500,Herb Wesson,500
206,89106,0,500,0,500,Herb Wesson,500
202,89032,0,0,500,500,Holly Mitchell,500
190,83646,0,500,0,500,Herb Wesson,500
185,80246,0,500,0,500,Herb Wesson,500
183,80206,0,500,0,500,Herb Wesson,500
182,80203,0,500,0,500,Herb Wesson,500
618,93551,0,0,500,500,Holly Mitchell,500
500,92106,0,0,500,500,Holly Mitchell,500
487,92014,0,0,500,500,Holly Mitchell,500
170,77005,0,0,500,500,Holly Mitchell,500
605,93215,0,0,500,500,Holly Mitchell,500
679,94542,0,0,450,450,Holly Mitchell,450
756,95608,0,0,450,450,Holly Mitchell,450
759,95628,0,0,450,450,Holly Mitchell,450
476,91784,0,200,200,400,Herb Wesson,200
535,92410,0,300,100,400,Herb Wesson,300
538,92504,0,0,400,400,Holly Mitchell,400
604,93105,0,388,0,388,Herb Wesson,388
657,94124,0,0,370,370,Holly Mitchell,370
29,11234,0,0,350,350,Holly Mitchell,350
716,94710,0,0,350,350,Holly Mitchell,350
95,30328,0,0,350,350,Holly Mitchell,350
780,95820,0,0,350,350,Holly Mitchell,350
501,92107,0,0,350,350,Holly Mitchell,350
536,92501,0,0,350,350,Holly Mitchell,350
787,95829,0,0,350,350,Holly Mitchell,350
116,37215,0,350,0,350,Herb Wesson,350
175,78660,0,0,332,332,Holly Mitchell,332
659,94129,0,0,305,305,Holly Mitchell,305
73,22033,0,300,0,300,Herb Wesson,300
122,38117,0,0,300,300,Holly Mitchell,300
159,68106,0,0,300,300,Holly Mitchell,300
629,93940,0,0,300,300,Holly Mitchell,300
595,92887,0,200,100,300,Herb Wesson,200
623,93721,0,0,275,275,Holly Mitchell,275
515,92131,0,275,0,275,Herb Wesson,275
731,95014,0,0,252,252,Holly Mitchell,252
674,94523,0,0,251,251,Holly Mitchell,251
748,95401,0,0,250,250,Holly Mitchell,250
126,48025,0,0,250,250,Holly Mitchell,250
148,63101,0,250,0,250,Herb Wesson,250
598,93012,0,250,0,250,Herb Wesson,250
597,93003,0,0,250,250,Holly Mitchell,250
117,37914,0,0,250,250,Holly Mitchell,250
592,92880,0,250,0,250,Herb Wesson,250
16,10025,0,0,250,250,Holly Mitchell,250
742,95125,0,0,250,250,Holly Mitchell,250
21,10176,0,250,0,250,Herb Wesson,250
96,30331,0,0,250,250,Holly Mitchell,250
762,95658,0,0,250,250,Holly Mitchell,250
157,66207,0,0,250,250,Holly Mitchell,250
452,91723,0,250,0,250,Herb Wesson,250
44,19119,0,0,250,250,Holly Mitchell,250
337,90701,0,250,0,250,Herb Wesson,250
328,90623,0,0,250,250,Holly Mitchell,250
615,93535,0,250,0,250,Herb Wesson,250
638,94066,0,0,250,250,Holly Mitchell,250
187,80634,0,250,0,250,Herb Wesson,250
189,8234,0,250,0,250,Herb Wesson,250
3,10004,0,0,250,250,Holly Mitchell,250
290,90251,0,0,250,250,Holly Mitchell,250
198,86336,0,0,250,250,Holly Mitchell,250
801,97232,0,0,250,250,Holly Mitchell,250
622,93711,0,0,250,250,Holly Mitchell,250
451,91722,0,250,0,250,Herb Wesson,250
720,94806,0,0,250,250,Holly Mitchell,250
89,28314,0,250,0,250,Herb Wesson,250
66,20854,0,0,250,250,Holly Mitchell,250
569,92663,0,250,0,250,Herb Wesson,250
521,92270,0,0,250,250,Holly Mitchell,250
518,92253,0,0,250,250,Holly Mitchell,250
34,11937,0,0,250,250,Holly Mitchell,250
72,2130,0,0,250,250,Holly Mitchell,250
64,20814,0,0,250,250,Holly Mitchell,250
681,94551,0,0,250,250,Holly Mitchell,250
453,91724,0,0,225,225,Holly Mitchell,225
655,94122,0,0,211,211,Holly Mitchell,211
460,91744,0,200,0,200,Herb Wesson,200
739,95120,0,0,200,200,Holly Mitchell,200
492,92057,0,200,0,200,Herb Wesson,200
82,23435,0,0,200,200,Holly Mitchell,200
336,90680,0,100,100,200,Herb Wesson,100
606,93306,0,0,200,200,Holly Mitchell,200
171,77018,0,0,200,200,Holly Mitchell,200
613,93465,0,0,200,200,Holly Mitchell,200
421,91381,0,200,0,200,Herb Wesson,200
738,95118,0,0,200,200,Holly Mitchell,200
181,80027,0,0,200,200,Holly Mitchell,200
144,60615,0,0,200,200,Holly Mitchell,200
750,95409,0,0,200,200,Holly Mitchell,200
4,10009,0,0,200,200,Holly Mitchell,200
545,92555,0,200,0,200,Herb Wesson,200
661,94134,0,0,200,200,Holly Mitchell,200
635,94061,0,0,200,200,Holly Mitchell,200
63,20707,0,0,200,200,Holly Mitchell,200
676,94534,0,0,200,200,Holly Mitchell,200
765,95670,0,0,150,150,Holly Mitchell,150
203,8904,0,0,150,150,Holly Mitchell,150
639,94070,0,0,150,150,Holly Mitchell,150
530,92395,0,0,150,150,Holly Mitchell,150
528,92376,0,0,150,150,Holly Mitchell,150
114,37208,0,0,150,150,Holly Mitchell,150
67,20906,0,0,150,150,Holly Mitchell,150
14,10023,0,0,135,135,Holly Mitchell,135
619,93561,0,0,125,125,Holly Mitchell,125
333,90650,0,125,0,125,Herb Wesson,125
760,95630,0,0,125,125,Holly Mitchell,125
665,94305,0,0,110,110,Holly Mitchell,110
808,98110,0,0,107,107,Holly Mitchell,107
27,11215,0,0,100,100,Holly Mitchell,100
102,32609,0,0,100,100,Holly Mitchell,100
698,94606,0,0,100,100,Holly Mitchell,100
715,94709,0,0,100,100,Holly Mitchell,100
497,92103,0,0,100,100,Holly Mitchell,100
621,93710,0,0,100,100,Holly Mitchell,100
422,91384,0,0,100,100,Holly Mitchell,100
793,95838,0,0,100,100,Holly Mitchell,100
257,90051,0,0,100,100,Holly Mitchell,100
292,90255,0,0,100,100,Holly Mitchell,100
273,90095,0,0,100,100,Holly Mitchell,100
213,90003,0,100,0,100,Herb Wesson,100
36,14850,0,0,100,100,Holly Mitchell,100
505,92114,0,0,100,100,Holly Mitchell,100
115,37210,0,0,100,100,Holly Mitchell,100
56,20015,0,0,100,100,Holly Mitchell,100
281,90227,0,0,100,100,Holly Mitchell,100
583,92832,0,100,0,100,Herb Wesson,100
447,91706,0,0,100,100,Holly Mitchell,100
636,94062,0,0,100,100,Holly Mitchell,100
145,6088,0,0,100,100,Holly Mitchell,100
176,78723,0,0,100,100,Holly Mitchell,100
755,95602,0,0,100,100,Holly Mitchell,100
475,91780,0,0,100,100,Holly Mitchell,100
132,53705,0,0,100,100,Holly Mitchell,100
601,93063,0,0,100,100,Holly Mitchell,100
761,95648,0,0,100,100,Holly Mitchell,100
705,94614,0,0,100,100,Holly Mitchell,100
155,6484,0,0,100,100,Holly Mitchell,100
721,94841,0,0,100,100,Holly Mitchell,100
766,95678,0,0,100,100,Holly Mitchell,100
544,92553,0,0,100,100,Holly Mitchell,100
654,94121,0,0,100,100,Holly Mitchell,100
342,90713,0,0,100,100,Holly Mitchell,100
118,37918,0,0,100,100,Holly Mitchell,100
773,95762,0,0,100,100,Holly Mitchell,100
166,76108,0,0,100,100,Holly Mitchell,100
32,11434,0,0,100,100,Holly Mitchell,100
28,11225,0,0,100,100,Holly Mitchell,100
8,10013,0,0,100,100,Holly Mitchell,100
412,91354,0,100,0,100,Herb Wesson,100
55,20011,0,0,100,100,Holly Mitchell,100
172,78028,0,0,100,100,Holly Mitchell,100
495,92083,0,0,100,100,Holly Mitchell,100
620,93636,0,0,75,75,Holly Mitchell,75
691,94585,0,0,55,55,Holly Mitchell,55
557,92620,0,0,0,0,Tie,0
